10031111111111111111111111111111111111
10011000000000000000000000000000000001
10000002002000000000000000000000000001
10000001001020000000000000000000010001
10000000000010000021140000000000010001
10000000000000000000014000000000020001
12222222222222222222211122222111110001
11111111200000000000000001110000010001
11111111112240000000100000000000010001
10001111111111000000000000000000010001
14000000000001000000000000050000000051
11400000000000000000000000511111111111
11140000000000000000000000000000000001
11112211110012000040000000000000000001
10000000000011000011400000000000000001
10000000000000000000142000000000000001
10000000000000000000000002511000000001
10000000000000000000000000100000000001
14000000000000000000000000000000000051
11111111111111111111111111111111111111

